#########
###...###
###.o.###
###...###
####.####
#.......#
#.......#
#...@...#
#.......#
#.......#
####.####
###...###
###.o.###
#########