#####################
#o........@........o#
#.#################.#
#.#################.#
#.........@.........#
#.#################.#
#.#################.#
#o.................o#
#####################