#####################
#o........@........o#
#.#################.#
#.#################.#
#.........@.........#
#.#################.#
#.#################.#
#o........@........o#
#####################