#####################
#.........#.........#
#.###.###.#.###.###.#
#o# #.# #.#.# #.# #o#
#.###.###.#.###.###.#
#...................#
#.###.#.#####.#.###.#
#.###.#.#####.#.###.#
#.....#...#...#.....#
#####.###.#.###.#####
----#.#...@...#.#----
----#.#.##=##.#.#----
#####.#.#---#.#.#####
.....@..#---#..@.....
#####.#.#####.#.#####
----#.#.......#.#----
----#.#.#####.#.#----
#####.#.#####.#.#####
#.........#.........#
#.###.###.#.###.###.#
#o..#.....@.....#..o#
###.#.#.#####.#.#.###
###.#.#.#####.#.#.###
#.....#...#...#.....#
#.#######.#.#######.#
#...................#
#####################