#####################
#.........#.........#
#.###.###.#.###.###.#
#.# #.# #.#.# #.# #.#
#.###.###.#.###.###.#
#...................#
#.###.#.#####.#.###.#
#.###.#.#####.#.###.#
#.....#...#...#.....#
#####.###.#.###.#####
    #.#.......#.#
    #.#.......#.#
#####.#.##-##.#.#####
........#   #........
#####.#.#####.#.#####
    #.#.......#.#
    #.#.#####.#.#
#####.#.#####.#.#####
#.........#.........#
#.###.###.#.###.###.#
#...#...........#...#
###.#.#.#####.#.#.###
###.#.#.#####.#.#.###
#.....#...#...#.....#
#.#######.#.#######.#
#...................#
#####################